1111111111111111111111111
1232333223333223223332221
120........00000000000.21
130........,..000....0.31
120000...............0.31
13.........0.........0.21
13...00000000..........31
12......0....0...0.....21
12..0..00....0...0.....21
13..0...0........0.....31
12..0...0000000000000..31
1232233322232232233233221
1111111111111111111111111